This icon is licensed as Creative Commons CCBY

https://thenounproject.com/

Agenda municipal: reunion by Phạm Thanh Lộc from the Noun Project
Agenda de actividades: public domain
Aparcamientos publicos: Car by Rainbow Designs from the Noun Project
Avisos, sugerencias: Document by tezar tantular from the Noun Project
Bicicleta pública: Bicycle by Riswan Ratta from the Noun Project
Calidad aire: Air by priyanka from the Noun Project
Callejero oficial: spot by Alice Design from the Noun Project
Censo de locales, actividades: Mortgage by Juraj Sedlák from the Noun Project
Contaminación acustica: Sound by ibrandify from the Noun Project
Contrataciones, licitatciones: papers by Pascal Heß from the Noun Project
Convenios: partnership by remmachenasreddine from the Noun Project
Deuda pública: debt by Symbolon from the Noun Project
Equipamientos municipales: building by Alice Design from the Noun Project
Tráfico: Trafic lights by Martin Vanco from the Noun Project
Instalaciones deportivas: olympic by sachan from the Noun Project
Lugar de intereés: place by The Icon Z from the Noun Project
Padrón municipal: people by Wilson Joseph from the Noun Project
Presupuesto municipal:paper check by Alfredo from the Noun Project
Punto acceso: wifi tower by BomSymbols from the Noun Project
Transporte público: Bus by i cons from the Noun Project
Cartografía munipal: place by shaurya from the Noun Project
Accidentes tráfico: Crash by fae frey from the Noun Project
Contenedores reciclaje: Recycle by nailil jamila from the Noun Project
Registro de asociaciones: drawer by Eucalyp from the Noun Project
Alojamientos, hoteles: Apartment by arif fauzi hakim from the Noun Project
Calidad de agua: Water by Kevin from the Noun Project
Carriles bici: lane by Mask Icon from the Noun Project
Alumbrado público: streetlight by Jacqueline Fernandes from the Noun Project
Subvenciones:Charity by Vectors Point from the Noun Project
Zonas infatiles: Playground by Komkrit Noenpoempisut from the Noun Project
Censo de empresas: folder with paper by Sérgio Filipe Cardoso Pires from the Noun Project
Facturas: bill by Alexander from the Noun Project
Censo de vehiculos: car lease by Aneeque Ahmed from the Noun Project
Inventario de bienes urbanos y rusticos: inventory by Smashing Stocks from the Noun Project
Parques y jardines:Tree by FayraLovers from the Noun Project
RPT:team by Marc Torrada from the Noun Project
Licencias urbanisticas: licensing by monkik from the Noun Project
Gestion de residuos:Trash by Pauel Tepikin from the Noun Project
Fuentes de agua:Fountain by Serhii Smirnov from the Noun Project
Sanciones y multas:fine by Made from the Noun Project
Icono error: Danger by Adrien Coquet from the Noun Project
Icono otros: Otros:other by Caesar Dwiky Darmawan from the Noun Project

